
NO ./textures/n.xpm
SO ./textures/blue_tex.xpm
WE ./textures/wood.xpm
EA ./textures/s.xpm

C    10,20,150
F    57,100,35

11111111111111111111111111111111111111111111
1000000000000000000000000000010E100000000001
10000000000000000000000000000100100000000001
11111111100000000000000000001100100000000001
10000000d00000000000000000000000000000000001
11111111100000000000000000000000000000000111
10000000000000000000000000000000000000000001
10000000000000000000000000000000100000001111
10000000000000000000000000000000001000001001
10000000000000000000000000000000000100010001
10000000000000000000000000000000000010100001
10000000000000000000000000000000000001000001
10000000100000000000000000000010000000000001
10000000010000000000000000000000000000000001
10000000000000000000000000000010000000000001
10000000000000000000000000000000000000000001
11111111111111111111111111111111111111111111
