
NO ./textures/n.xpm
SO ./textures/s.xpm
WE ./textures/w.xpm
EA ./textures/e.xpm


C 255,205,200
F 0,53,25

111
111111111111111111111111111111111111111111111111111  11111
1111111      11111111                     1111111111111111
    101111111111011111                   1111111111111111
11111111111111111011111111                           11111
1111111111111111111111111           111111111
                        11111111111110N0000111111
                                 1111111111111111
                                   111111111111
111111111111111
100000001111111
11111111111111


EA ./textures/e.xpm