
NO ./textures/blue_tex.xpm
SO ./textures/n.xpm
WE ./textures/wood.xpm
EA ./textures/s.xpm


F 0,53,25
C 255,205,200

11111111111111111111111111111111111111111111111111111111111111111111111111111111111111
10000000000000000000000000000000000000000000000000000000000000000000000000000000000001
10000000000000000000000000000000000000000000000000000000000000000000000000000000000001
10000000000000000000000000001000000000000000000000000000000000000000000000000000000001
10000000100000000000000000000000000000000000000000000000000000000000000000000000000001
10000000010000000000000000000000000000000000000000000000000000000000000000000000000001
10000000000000000000000000000000000000000000000000000000000000000000000000000000000001
100000N0000000000000000000000000000000000000000000000000000000000000000000000000000001
10000000000000000000000000000000000000000000000000000000000000000000000000000000000001
10000000000000000000000000000000001100000000000000000000000000000000000000000000000001
10000000000000000000000000000000000010000000000000000000000000000000000000000000000001
10000000000000000000000000000000000001000000000000000000000000000000000000000000000001
10000000100000000000000000000010000000000000000000000000000000000000000000000000000001
10000000010000000000000000000000000000000000000000000000000000000000000000000000000001
10000000000000000000000000000010000000000000000000000000000000000000000000000000000001
10000000000000000000000000000000000000000000000000000000000000000000000000000000000001
10000000000000000000000000001000000000000000000000000000000000000000000000000000000001
10000000100000000000000000000000000000000000000000000000000000000000000000000000000001
10000000010000000000000000000000000000000000000000000000000000000000000000000000000001
10000000000000000000000000000000000000000000000000000000000000000000000000000000000001
10000000000000000000000000000000000000000000000000000000000000000000000000000000000001
10000000000000000000000000000000000000000000000000000000000000000000000000000000000001
10000000000000000000000000000000001100000000000000000000000000000000000000000000000001
10000000000000000000000000001000000000000000000000000000000000000000000000000000000001
10000000100000000000000000000000000000000000000000000000000000000000000000000000000001
10000000010000000000000000000000000000000000000000000000000000000000000000000000000001
10000000000000000000000000000000000000000000000000000000000000000000000000000000000001
10000000000000000000000000000000000000000000000000000000000000000000000000000000000001
10000000000000000000000000000000000000000000000000000000000000000000000000000000000001
10000000000000000000000000000000001100000000000000000000000000000000000000000000000001
10000000000000000000000000001000000000000000000000000000000000000000000000000000000001
10000000100000000000000000000000000000000000000000000000000000000000000000000000000001
10000000010000000000000000000000000000000000000000000000000000000000000000000000000001
10000000000000000000000000000000000000000000000000000000000000000000000000000000000001
10000000000000000000000000000000000000000000000000000000000000000000000000000000000001
10000000000000000000000000000000000000000000000000000000000000000000000000000000000001
10000000000000000000000000000000001100000000000000000000000000000000000000000000000001
10000000000000000000000000001000000000000000000000000000000000000000000000000000000001
10000000100000000000000000000000000000000000000000000000000000000000000000000000000001
10000000010000000000000000000000000000000000000000000000000000000000000000000000000001
10000000000000000000000000000000000000000000000000000000000000000000000000000000000001
10000000000000000000000000000000000000000000000000000000000000000000000000000000000001
10000000000000000000000000000000000000000000000000000000000000000000000000000000000001
10000000000000000000000000000000001100000000000000000000000000000000000000000000000001
10000000000000000000000000000000000000000000000000000000000000000000000000000000000001
10000000000000000000000000000000001100000000000000000000000000000000000000000000000001
10000000000000000000000000000000000010000000000000000000000000000000000000000000000001
10000000000000000000000000000000000001000000000000000000000000000000000000000000000001
10000000100000000000000000000010000000000000000000000000000000000000000000000000000001
10000000010000000000000000000000000000000000000000000000000000000000000000000000000001
10000000000000000000000000000010000000000000000000000000000000000000000000000000000001
10000000000000000000000000000000000000000000000000000000000000000000000000000000000001
10000000000000000000000000001000000000000000000000000000000000000000000000000000000001
10000000100000000000000000000000000000000000000000000000000000000000000000000000000001
10000000010000000000000000000000000000000000000000000000000000000000000000000000000001
10000000000000000000000000000000000000000000000000000000000000000000000000000000000001
10000000000000000000000000000000000000000000000000000000000000000000000000000000000001
10000000000000000000000000000000000000000000000000000000000000000000000000000000000001
10000000000000000000000000000000001100000000000000000000000000000000000000000000000001
10000000000000000000000000001000000000000000000000000000000000000000000000000000000001
10000000100000000000000000000000000000000000000000000000000000000000000000000000000001
10000000010000000000000000000000000000000000000000000000000000000000000000000000000001
10000000000000000000000000000000000000000000000000000000000000000000000000000000000001
10000000000000000000000000000000000000000000000000000000000000000000000000000000000001
10000000000000000000000000000000000000000000000000000000000000000000000000000000000001
10000000000000000000000000000000001100000000000000000000000000000000000000000000000001
10000000000000000000000000001000000000000000000000000000000000000000000000000000000001
10000000100000000000000000000000000000000000000000000000000000000000000000000000000001
10000000010000000000000000000000000000000000000000000000000000000000000000000000000001
10000000000000000000000000000000000000000000000000000000000000000000000000000000000001
10000000000000000000000000000000000000000000000000000000000000000000000000000000000001
10000000000000000000000000000000000000000000000000000000000000000000000000000000000001
10000000000000000000000000000000001100000000000000000000000000000000000000000000000001
10000000000000000000000000001000000000000000000000000000000000000000000000000000000001
10000000100000000000000000000000000000000000000000000000000000000000000000000000000001
10000000010000000000000000000000000000000000000000000000000000000000000000000000000001
10000000000000000000000000000000000000000000000000000000000000000000000000000000000001
10000000000000000000000000000000000000000000000000000000000000000000000000000000000001
10000000000000000000000000000000000000000000000000000000000000000000000000000000000001
10000000000000000000000000000000001100000000000000000000000000000000000000000000000001
10000000000000000000000000000000000000000000000000000000000000000000000000000000000001
10000000000000000000000000000000001100000000000000000000000000000000000000000000000001
10000000000000000000000000000000000010000000000000000000000000000000000000000000000001
10000000000000000000000000000000000001000000000000000000000000000000000000000000000001
10000000100000000000000000000010000000000000000000000000000000000000000000000000000001
10000000010000000000000000000000000000000000000000000000000000000000000000000000000001
10000000000000000000000000000010000000000000000000000000000000000000000000000000000001
10000000000000000000000000000000000000000000000000000000000000000000000000000000000001
10000000000000000000000000001000000000000000000000000000000000000000000000000000000001
10000000100000000000000000000000000000000000000000000000000000000000000000000000000001
10000000010000000000000000000000000000000000000000000000000000000000000000000000000001
10000000000000000000000000000000000000000000000000000000000000000000000000000000000001
10000000000000000000000000000000000000000000000000000000000000000000000000000000000001
10000000000000000000000000000000000000000000000000000000000000000000000000000000000001
10000000000000000000000000000000001100000000000000000000000000000000000000000000000001
10000000000000000000000000001000000000000000000000000000000000000000000000000000000001
10000000100000000000000000000000000000000000000000000000000000000000000000000000000001
10000000010000000000000000000000000000000000000000000000000000000000000000000000000001
10000000000000000000000000000000000000000000000000000000000000000000000000000000000001
10000000000000000000000000000000000000000000000000000000000000000000000000000000000001
10000000000000000000000000000000000000000000000000000000000000000000000000000000000001
10000000000000000000000000000000001100000000000000000000000000000000000000000000000001
10000000000000000000000000001000000000000000000000000000000000000000000000000000000001
10000000100000000000000000000000000000000000000000000000000000000000000000000000000001
10000000010000000000000000000000000000000000000000000000000000000000000000000000000001
10000000000000000000000000000000000000000000000000000000000000000000000000000000000001
10000000000000000000000000000000000000000000000000000000000000000000000000000000000001
10000000000000000000000000000000000000000000000000000000000000000000000000000000000001
10000000000000000000000000000000001100000000000000000000000000000000000000000000000001
10000000000000000000000000001000000000000000000000000000000000000000000000000000000001
10000000100000000000000000000000000000000000000000000000000000000000000000000000000001
10000000010000000000000000000000000000000000000000000000000000000000000000000000000001
10000000000000000000000000000000000000000000000000000000000000000000000000000000000001
10000000000000000000000000000000000000000000000000000000000000000000000000000000000001
10000000000000000000000000000000000000000000000000000000000000000000000000000000000001
10000000000000000000000000000000001100000000000000000000000000000000000000000000000001
10000000000000000000000000000000000000000000000000000000000000000000000000000000000001
10000000000000000000000000000000001100000000000000000000000000000000000000000000000001
10000000000000000000000000000000000010000000000000000000000000000000000000000000000001
10000000000000000000000000000000000001000000000000000000000000000000000000000000000001
10000000100000000000000000000010000000000000000000000000000000000000000000000000000001
10000000010000000000000000000000000000000000000000000000000000000000000000000000000001
10000000000000000000000000000010000000000000000000000000000000000000000000000000000001
10000000000000000000000000000000000000000000000000000000000000000000000000000000000001
10000000000000000000000000001000000000000000000000000000000000000000000000000000000001
10000000100000000000000000000000000000000000000000000000000000000000000000000000000001
10000000010000000000000000000000000000000000000000000000000000000000000000000000000001
10000000000000000000000000000000000000000000000000000000000000000000000000000000000001
10000000000000000000000000000000000000000000000000000000000000000000000000000000000001
10000000000000000000000000000000000000000000000000000000000000000000000000000000000001
10000000000000000000000000000000001100000000000000000000000000000000000000000000000001
10000000000000000000000000001000000000000000000000000000000000000000000000000000000001
10000000100000000000000000000000000000000000000000000000000000000000000000000000000001
10000000010000000000000000000000000000000000000000000000000000000000000000000000000001
10000000000000000000000000000000000000000000000000000000000000000000000000000000000001
10000000000000000000000000000000000000000000000000000000000000000000000000000000000001
10000000000000000000000000000000000000000000000000000000000000000000000000000000000001
10000000000000000000000000000000001100000000000000000000000000000000000000000000000001
10000000000000000000000000001000000000000000000000000000000000000000000000000000000001
10000000100000000000000000000000000000000000000000000000000000000000000000000000000001
10000000010000000000000000000000000000000000000000000000000000000000000000000000000001
10000000000000000000000000000000000000000000000000000000000000000000000000000000000001
10000000000000000000000000000000000000000000000000000000000000000000000000000000000001
10000000000000000000000000000000000000000000000000000000000000000000000000000000000001
10000000000000000000000000000000001100000000000000000000000000000000000000000000000001
10000000000000000000000000001000000000000000000000000000000000000000000000000000000001
10000000100000000000000000000000000000000000000000000000000000000000000000000000000001
10000000010000000000000000000000000000000000000000000000000000000000000000000000000001
10000000000000000000000000000000000000000000000000000000000000000000000000000000000001
10000000000000000000000000000000000000000000000000000000000000000000000000000000000001
10000000000000000000000000000000000000000000000000000000000000000000000000000000000001
10000000000000000000000000000000001100000000000000000000000000000000000000000000000001
10000000000000000000000000000000000000000000000000000000000000000000000000000000000001
10000000000000000000000000000000001100000000000000000000000000000000000000000000000001
10000000000000000000000000000000000010000000000000000000000000000000000000000000000001
10000000000000000000000000000000000001000000000000000000000000000000000000000000000001
10000000100000000000000000000010000000000000000000000000000000000000000000000000000001
10000000010000000000000000000000000000000000000000000000000000000000000000000000000001
10000000000000000000000000000010000000000000000000000000000000000000000000000000000001
10000000000000000000000000000000000000000000000000000000000000000000000000000000000001
10000000000000000000000000001000000000000000000000000000000000000000000000000000000001
10000000100000000000000000000000000000000000000000000000000000000000000000000000000001
10000000010000000000000000000000000000000000000000000000000000000000000000000000000001
10000000000000000000000000000000000000000000000000000000000000000000000000000000000001
10000000000000000000000000000000000000000000000000000000000000000000000000000000000001
10000000000000000000000000000000000000000000000000000000000000000000000000000000000001
10000000000000000000000000000000001100000000000000000000000000000000000000000000000001
10000000000000000000000000001000000000000000000000000000000000000000000000000000000001
10000000100000000000000000000000000000000000000000000000000000000000000000000000000001
10000000010000000000000000000000000000000000000000000000000000000000000000000000000001
10000000000000000000000000000000000000000000000000000000000000000000000000000000000001
10000000000000000000000000000000000000000000000000000000000000000000000000000000000001
10000000000000000000000000000000000000000000000000000000000000000000000000000000000001
10000000000000000000000000000000001100000000000000000000000000000000000000000000000001
10000000000000000000000000001000000000000000000000000000000000000000000000000000000001
10000000100000000000000000000000000000000000000000000000000000000000000000000000000001
10000000010000000000000000000000000000000000000000000000000000000000000000000000000001
10000000000000000000000000000000000000000000000000000000000000000000000000000000000001
10000000000000000000000000000000000000000000000000000000000000000000000000000000000001
10000000000000000000000000000000000000000000000000000000000000000000000000000000000001
10000000000000000000000000000000001100000000000000000000000000000000000000000000000001
10000000000000000000000000001000000000000000000000000000000000000000000000000000000001
10000000100000000000000000000000000000000000000000000000000000000000000000000000000001
10000000010000000000000000000000000000000000000000000000000000000000000000000000000001
10000000000000000000000000000000000000000000000000000000000000000000000000000000000001
10000000000000000000000000000000000000000000000000000000000000000000000000000000000001
10000000000000000000000000000000000000000000000000000000000000000000000000000000000001
10000000000000000000000000000000001100000000000000000000000000000000000000000000000001
10000000000000000000000000000000000000000000000000000000000000000000000000000000000001
10000000000000000000000000000000001100000000000000000000000000000000000000000000000001
10000000000000000000000000000000000010000000000000000000000000000000000000000000000001
10000000000000000000000000000000000001000000000000000000000000000000000000000000000001
10000000100000000000000000000010000000000000000000000000000000000000000000000000000001
10000000010000000000000000000000000000000000000000000000000000000000000000000000000001
10000000000000000000000000000010000000000000000000000000000000000000000000000000000001
10000000000000000000000000000000000000000000000000000000000000000000000000000000000001
10000000000000000000000000001000000000000000000000000000000000000000000000000000000001
10000000100000000000000000000000000000000000000000000000000000000000000000000000000001
10000000010000000000000000000000000000000000000000000000000000000000000000000000000001
10000000000000000000000000000000000000000000000000000000000000000000000000000000000001
10000000000000000000000000000000000000000000000000000000000000000000000000000000000001
10000000000000000000000000000000000000000000000000000000000000000000000000000000000001
10000000000000000000000000000000001100000000000000000000000000000000000000000000000001
10000000000000000000000000001000000000000000000000000000000000000000000000000000000001
10000000100000000000000000000000000000000000000000000000000000000000000000000000000001
10000000010000000000000000000000000000000000000000000000000000000000000000000000000001
10000000000000000000000000000000000000000000000000000000000000000000000000000000000001
10000000000000000000000000000000000000000000000000000000000000000000000000000000000001
10000000000000000000000000000000000000000000000000000000000000000000000000000000000001
10000000000000000000000000000000001100000000000000000000000000000000000000000000000001
10000000000000000000000000001000000000000000000000000000000000000000000000000000000001
10000000100000000000000000000000000000000000000000000000000000000000000000000000000001
10000000010000000000000000000000000000000000000000000000000000000000000000000000000001
10000000000000000000000000000000000000000000000000000000000000000000000000000000000001
10000000000000000000000000000000000000000000000000000000000000000000000000000000000001
10000000000000000000000000000000000000000000000000000000000000000000000000000000000001
10000000000000000000000000000000001100000000000000000000000000000000000000000000000001
10000000000000000000000000001000000000000000000000000000000000000000000000000000000001
10000000100000000000000000000000000000000000000000000000000000000000000000000000000001
10000000010000000000000000000000000000000000000000000000000000000000000000000000000001
10000000000000000000000000000000000000000000000000000000000000000000000000000000000001
10000000000000000000000000000000000000000000000000000000000000000000000000000000000001
10000000000000000000000000000000000000000000000000000000000000000000000000000000000001
10000000000000000000000000000000001100000000000000000000000000000000000000000000000001
10000000000000000000000000000000000000000000000000000000000000000000000000000000000001
10000000000000000000000000000000001100000000000000000000000000000000000000000000000001
10000000000000000000000000000000000010000000000000000000000000000000000000000000000001
10000000000000000000000000000000000001000000000000000000000000000000000000000000000001
10000000100000000000000000000010000000000000000000000000000000000000000000000000000001
10000000010000000000000000000000000000000000000000000000000000000000000000000000000001
10000000000000000000000000000010000000000000000000000000000000000000000000000000000001
10000000000000000000000000000000000000000000000000000000000000000000000000000000000001
10000000000000000000000000001000000000000000000000000000000000000000000000000000000001
10000000100000000000000000000000000000000000000000000000000000000000000000000000000001
10000000010000000000000000000000000000000000000000000000000000000000000000000000000001
10000000000000000000000000000000000000000000000000000000000000000000000000000000000001
10000000000000000000000000000000000000000000000000000000000000000000000000000000000001
10000000000000000000000000000000000000000000000000000000000000000000000000000000000001
10000000000000000000000000000000001100000000000000000000000000000000000000000000000001
10000000000000000000000000001000000000000000000000000000000000000000000000000000000001
10000000100000000000000000000000000000000000000000000000000000000000000000000000000001
10000000010000000000000000000000000000000000000000000000000000000000000000000000000001
10000000000000000000000000000000000000000000000000000000000000000000000000000000000001
10000000000000000000000000000000000000000000000000000000000000000000000000000000000001
10000000000000000000000000000000000000000000000000000000000000000000000000000000000001
10000000000000000000000000000000001100000000000000000000000000000000000000000000000001
10000000000000000000000000001000000000000000000000000000000000000000000000000000000001
10000000100000000000000000000000000000000000000000000000000000000000000000000000000001
10000000010000000000000000000000000000000000000000000000000000000000000000000000000001
10000000000000000000000000000000000000000000000000000000000000000000000000000000000001
10000000000000000000000000000000000000000000000000000000000000000000000000000000000001
10000000000000000000000000000000000000000000000000000000000000000000000000000000000001
10000000000000000000000000000000001100000000000000000000000000000000000000000000000001
10000000000000000000000000001000000000000000000000000000000000000000000000000000000001
10000000100000000000000000000000000000000000000000000000000000000000000000000000000001
10000000010000000000000000000000000000000000000000000000000000000000000000000000000001
10000000000000000000000000000000000000000000000000000000000000000000000000000000000001
10000000000000000000000000000000000000000000000000000000000000000000000000000000000001
10000000000000000000000000000000000000000000000000000000000000000000000000000000000001
10000000000000000000000000000000001100000000000000000000000000000000000000000000000001
11111111111111111111111111111111111111111111111111111111111111111111111111111111111111
