
C    10,20,150
F    57,100,35

NO ./textures/n.xpm
SO ./textures/blue_tex.xpm
WE ./textures/wood.xpm
EA ./textures/s.xpm

11111111111111111111111111111111111111111111
10000000000000000000000000000000000000000001
10000000000000000000000000000000000000000001
10000000000000000000000000001000000000000001
10000000100000000000000000000000000000000001
1000000000000000000000000000000000000000000111
1000000000000000000000000000000000000000000001
100000N000000000000000000000000010000000101111
10000000000000000000000000000000001000001001
10000000000000000000000000000000000100010001
10000000000000000000000000000000000010100001
10000000000000000000000000000000000001000001
10000000100000000000000000000010000000000001
10000000010000000000000000000000000000000001
10000000000000000000000000000010000000000001
10000000000000000000000000000000000000000001
11111111111111111111111111111111111111111111
